#####
#@  #
# #$###
# $ ..#
#######
;
#######
#.   .#
#.$$$.#
##$@$##
#.$$$.#
#.   .#
#######
;
#######
#. $..#
#. $  #
#$$#$$#
# @$ .#
#..$ .#
#######
;
######
#@   ##
# $$  #
# #. .#
#     #
#######
;
######
#    ###
#   .. #
# $$$@ #
#  # . #
########