#####
#@$.#
#####
;
 ########
##  .   #
#   $   #
# .$@$. #
####$   #
   #.   #
   #   ##
   #####
;
#####
# @ #
# $ #
#   #
#   #
#   #####
#      .#
#  ######
#####